NO assets/cmoore6.png
SO assets/cmoore6.png
WE assets/cmoore6.png
EA assets/cmoore6.png

F 220,100,0
C 225,30,0

11111111111 1111111111111
1N00000000111000000000001
1011000001110000000000001
100100000000000000000000111111111
111111111011000001110000000000001
100000000111000001110111111111111
1111011111 111011100000010001
11110111111111011101010010001
11000000110101011100000010001
11100000000000001100000000001111
   10000000000000001101010010001
1110000111010101111101111000111
10000011 1110101 101111010001
11111111 1111111 111111111111